|                                                |
|                                                |
|                                                |
|                                                |
|   _______  _______  _______  _______  _______  |
|  |       ||       ||   _   ||       ||       | |
|  |  _____||_     _||  |_|  ||    ___||    ___| |
|  | |_____   |   |  |       ||   | __ |   |___  |
|  |_____  |  |   |  |       ||   ||  ||    ___| |
|   _____| |  |   |  |   _   ||   |_| ||   |___  |
|  |_______|  |___|  |__| |__||_______||_______| |
|                                                |
|                        __                      |
|                   ...-'  |`.                   |
|                   |      |  |                  |
|                   ....   |  |                  |
|                     -|   |  |                  |
|                      |   |  |                  |
|                   ...'   `--'                  |
|                  |         |`.                 |
|                  ` --------\ |                 |
|                    `---------'                 |
|                                                |
|                                                |
|   == Weapon Available: Gattling Gun            |
|   == Initial Health Points: 10                 |
|   == Enemies: Craft X                          |
|                                                |
|                                                |
|                                                |
|                                                |
|                                                |
|                                                |
|                                                |
|* Press 'c' to continue                         |
